1111111111111
10010000000C11
10000111101111
1P0011E0000011
1111111111111
     1111