1111111011111
10010000000C1
1000011110111
1P0011E000001
1111111111111
