1111111111111111111111111111111111
1111111111100000000000000000000011
1C00000111101111111111111111111011
1111100111101111111111111111111011
1111100000000000111111111111100011
11111111111111000000000000111011E1
1C00000000000000111111110011100001
1111111001011111111111110011111111
1P00000001C111111111111100000C0001
1111111111111111111111111111111111
